#####################################    #####################################
#///////////////////////////////////#    #\\\\\\\\\\\\\\\#===#\\\\\\\\\\\\\\\#
#///////////////////////////////////#    #\\\\\\\\\\\\\\\#===#\\\\\\\\\\\\\\\#
#///////////////////////////////////#    #\\\\\\\\\\######===######\\\\\\\\\\#
#///////////////////////////////////#    #\\\\\\\\\\#=============#\\\\\\\\\\#
#////////////////////////////////////    \\\\\\\\\\\######===######\\\\\\\\\\#
#////////////////////////////////////    \\\\\\\\\\\\\\\\#===#\\\\\\\\\\\\\\\#
#//////////////////////////////////##    ##\\\\\\\\\\\\\\#===#\\\\\\\\\\\\\\\#
###############//////////////////### ==== ###\\\\\\\\\\\\##-##\###############
#                                  ===[]===                                  #
#                                  ===  ===                                  #
###############\\\\\\\\\\\\\\\\\\### ==== ###//////////////////###############
#\\\\\\\\\\\\\\\\\\\\\\\\\\\\\\\\\\##    ##//////////////////////////////////#
#\\\\\\\\\\\\\\\\\\\\\\\\\\\\\\\\\\\\    ////////////////////////////////////#
#\\\\\\\\\\\\\#########\\\\\\\\\\\\\\    ////////////////////////////////////#
#\\\\\\\\\\\\\==STORE==\\\\\\\\\\\\\#    #///////////////////////////////////#
#\\\\\\\\\\\\\#########\\\\\\\\\\\\\#    #///////////////////////////////////#
#\\\\\\\\\\\\\\\\\\\\\\\\\\\\\\\\\\\#    #///////////////////////////////////#
#\\\\\\\\\\\\\\\\\\\\\\\\\\\\\\\\\\\#    #///////////////////////////////////#
#####################################    #####################################
