+‡ÿþ#####################################    #####################################
#            ########################    ########################            #
#          ##########################    ##########################          #
#        ############################    ############################        #
#      ##############################    ##############################      #
#    ################################    ################################    #
#  #################################======#################################  #
# ################################==========################################ #
################################====------====################################
===================================-  ??  -===================================
===================================-  ??  -===================================
################################====------====################################
#===============================##==========##===============================#
##===============================###======###===============================##
# ##===============================##    ##===============================## #
#   ##==============================#    #==============================##   #
#     ##============================#    #============================##     #
#       ##==========================#    #==========================##       #
#         ##========================#    #========================##         #
#####################################    #####################################
