#####################################    #####################################
#///////////////////////////////////#    #\\\\\\\\\\\\\\\\\\\\\\\\\\\\\\\\\\\#
#///////////////////////////////////#    #\\\\\\\\\\\\\\\\\\\\\\\\\\\\\\\\\\\#
#///////////////////////////////////#    #\\\\\\\\\\\\\\\\\\\\\\\\\\\\\\\\\\\#
#///////////////////////////////////#    #\\\\\\\\\\\\\\\\\\\\\\\\\\\\\\\\\\\#
#////////////////////////////////////    \\\\\\\\\\\\\\\\\\\\\\\\\\\\\\\\\\\\#
#////////////////////////////////////    \\\\\\\\\\\\\\\\\\\\\\\\\\\\\\\\\\\\#
#//////////////////////////////////##    ##\\\\\\\\\\\\\\\\\\\\\\\\\\\\\\\\\\#
#################////////////////### ==== ###\\\\\\\\\\\\\\\\#################
#                                  ===[]===                                  #
#                                  ===  ===                                  #
#################\\\\\\\\\\\\\\\\### ==== ###////////////////#################
#\\\\\\\\\\\\\\\\\\\\\\\\\\\\\\\\\\##    ##//////////////////////////////////#
#\\\\\\\\\\\\\\\\\\\\\\\\\\\\\\\\\\\\    ////////////////////////////////////#
#\\\\\\\\\\\\\\\\\\\\\\\\\\\\\\\\\\\\    ////////////////////////////////////#
#\\\\\\\\\\\\\\\\\\\\\\\\\\\\\\\\\\\#    #///////////////////////////////////#
#\\\\\\\\\\\\\\\\\\\\\\\\\\\\\\\\\\\#    #///////////////////////////////////#
#\\\\\\\\\\\\\\\\\\\\\\\\\\\\\\\\\\\#    #///////////////////////////////////#
#\\\\\\\\\\\\\\\\\\\\\\\\\\\\\\\\\\\#    #///////////////////////////////////#
#####################################    #####################################
